0001222223000
0004555556000
0004555556000
000455F556000
0004555556000
0004555556000
122d55555c223
455e555555556
4555555555556
4555555555556
455R5R5R5R556
4555555555556
4555555555556
4555555555556
4555555555556
4555555555556
7888b555a8889
0000455560000
1222d555c2223
4e5555555e556
4555555555556
4555555555556
4555555555556
4555555555556
4555555555556
4555555555556
4555555555556
4555555555556
7888b555a8889
0000455560000
0001d555c3000
001d55555c300
01d5555555c30
0788b555a8890
0000455560000
0000455560000
0000455560000
0000788890000