0001222223000
0004555556000
0004555556000
000455F556000
0004555556000
0004555556000
012d55555c230
04555E5E55560
0455555555560
0455555555560
045e555555560
0455555555560
0455555555560
0455R5R5R5560
0455555555560
0455555555560
0788b555a8890
0000455560000
1222d555c2223
4e55555555e56
4555555555556
455R55555R556
4555555555556
455R55555R556
4555555555556
455R55555R556
788b55555a889
0008b555a8000
0001d555c3000
001d55555c300
01d5555555c30
0788b555a8890
0000455560000
0000455560000
0000455560000
0000788890000