0001222223000
0004555556000
0004555556000
000455F556000
0004555556000
0004555556000
012d55555c230
0455555555560
04e55555e5560
0455555555560
0455555555560
0455555555560
0455555555560
0455555555560
0455555555560
0455555555560
0455555555560
0455555555560
0455555555560
0455555555560
0455555555560
0455555555560
0455555555560
0455555555560
0455555555560
0455555555560
0455555555560
07888b5a88890
1222345612223
4e5564564e556
4555645645556
4555645645556
4555645645556
4555645645556
4555645645556
7888945678889
00001d5c30000
00004e5560000
0000455560000
0000455560000
0000455560000
0000455560000
0000455560000
0001d555c3000
0004555556000
0004555556000
0007b555a9000
0000455560000
0000455560000
0001d555c3000
001d55555c300
0078b555a8900
0000455560000
0000455560000
0000455560000
0000788890000